111111111111111111
1000000J10000010C1
10P000000000001J01
1000S10000000J0001
10000000C00J0010E1
111111111111111111
