1111111111111111111111111111111111111111
1000001000000000000000000000000000000001
10000100000011011C000000000IC00000110001
10000010000010J01000010010000000001J00J1
100P000000000JSJ00000000100IC000001000E1
10000010000010J01000010010000000001J00J1
10000100000011011C000000000IC00000110001
1000001000000000000000000000000000000001
1111111111111111111111111111111111111111
