11111111111111111111111111111111
1C00000001000C000000C000000C0001
10000000000000000101111100000C01
100000C0011110000000000000000011
100000000000JP00000000S0000001E1
100000000000000010000100010001J1
100000001100S0001000011011000001
10JJ0J0010I00001100001J1S100I001
1JJ0J000100000001000010001000001
10JJJ00C00000J0J000001000C000001
11111111111111111111111111111111
