1111111111111111111111111111111111111111111111
1C0010I00C0010100001JS1000111100000C10000001E1
10000001110110101001000010000000000010010111C1
1000100100000010101111101111110110110010000101
1000000000001010000001J0J1I0000100000010000001
1000110111001010001001111100000100001111011111
1110010010I01C0000100100000C0000010001000010I1
1P00000010001J100010000000000001000C0000100001
1111111111111111111111111111111111111111111111
