11111111111111111111111111111111111111111111111111111111111
1JJJJJJ0000000000000000000000000000000000000000000000000001
1JJJJJJ0000000000000000000001000000J00000000000000000000001
1EJJJJJ0I0C000000000000000000100000000000000000S000000CP001
1JJJJJJ0000000000000000000000000000000000000000000000000001
11111111111111111111111111111111111111111111111111111111111
