11111111111111111111111111111111111111111111111111111111
10010000000C000000000C00000010000000C0000000000000000001
1000011111000000P000000000000000000000000000100000000001
100011E0000000000000000000000000000000000000100000000001
100000000000I00000010000000010000000C0000000000I00000001
1000000000000000001C000000000000000000000000100000000001
10000000000000000001000000000000000000000000100000000001
1000C0000000000000000000000010000000C0000000000000000001
10000000000000000001000000000000000000000000100000000001
1000C0000000000000000000000I10000000C0000000000000000001
10000000000000000001000000000000000000000000100000000001
1000C0000000000000000000000010000000C0000000000000000001
1000C0000000000000000000000010000000C0000000000000000001
10000000000000000001000000000000000000000000100000000001
1000C0000000000000000000000010000000C0000000000000000001
10000000000000000001000000000000000000000000100000000001
1000C0000000000000000000000010000000C0000000000000000001
1000C0000000000000000000000010000000C0000000000000000001
10000000000000000001000000000000000000000000100000000001
1000C0000000000000000000000010000000C0000000000000000001
10000000000000000001000000000000000000000000100000000001
1000C0000000000000000000000010000000C0000000000000000001
1000C0000000000000000000000010000000C0000000000000000001
10000000000000000001000000000000000000000000100000000001
1000C0000000000000000000000010000000C0000000000000000001
10000000000000000001000000000000000000000000100000000001
1000C0000000000000000000000010000000C0000000000000000001
1000C0000000000000000000000010000000C0000000000000000001
1000C0000000000000000000000010000000C0000000000000000001
11111111111111111111111111111111111111111111111111111111