11111111111111111111111111111111111111111111111111111111111
1000000010000000000001I000000000001C000C10I0000000000000001
10000000C0000000100000000C10000000100J001111100011111111001
100000001C0000001111111111100000001000000000100000000000001
100000001JC0000010000I0000101111111010100000100011111C11111
111C111111C111111000111000100000001001000000100010000000001
100000001000000010000000001111011010000000001000100001J0001
10101010100J0000101000001010000010111C111111100010000J00001
1P000000C0J0000C1I100SJ010C0001C10C00000000000101J100E010J1
10101010100J000010100000101000CJ10111C111111100010000J00001
100000001000000010000000001111011010000000001000100001J0001
111C1111111111C11000111000100000001000000000100010000000001
100000001JC0000010000I00001001111110J0000000100011111C11111
100000001C0000001111111111100100000000000000100010000000001
10000000C0000000100000000010010000J00J000111100011111111011
100000001000000000000100000001000C00000001I0000000000000001
11111111111111111111111111111111111111111111111111111111111
