1111111111111111111111111111
1000E00000100000000000000001
1000000000000000000100C00001
1000001011100000010100000001
1000001000000C00010000000001
10000010P0010000010000I00001
1000001000010000010000I00001
1000001000010000010000I00001
1000001000010000010000I00001
1000001000010000010000I00001
1000001000010000010000I00001
1000001000010000010000I00001
1000001000010000010000I00001
1000001000010000010000I00001
1000001000010000010000I00001
1000001000010000010000I00001
1000001000010000010000I00001
1000001000010000010000I00001
1000001000010000010000I00001
1000001000010000010000I00001
1000001000010000010000I00001
1000001000010000010000I00001
1000001000010000010000I00001
1000001000010000010000I00001
1000001000010000010000I00001
1000001000010000010000I00001
1000001000010000010000I00001
1000001000010000010000I00001
1000001000010000010000I00001
1111111111111111111111111111
