1111111
10C00P1
101E1C1
1111111E
1111111